\           .             .    ..                               .  .              .              /
 \          .                        .          .         .. . .                       .        / 
  \          .                           .              .                                      /  
  .\                                  .    .                           .            .         /   
    \                                         .                 .      .      .        .     /    
     \                     .        .                                           .           /.   .
  .   \ .                              .  .   .              .                             /      
.      \    .               .            .                    .                  .        /       
        |################################################################################|        
        |################################################################################|        
        |################################################################################|  .     
    .   |################################################################################|.       
    .   |################################################################################|.       
   .    |################################################################################|  .     
    .   |################################################################################|   .    
        |################################################################################|. .     
        |################################################################################|        
        |################################################################################|    .   
   .   /                                        .                             .  .        \       
      /   .              ..                         .          .                           \      
    ./ .          .                      . .                         . .       .            \     
    /                    .             .          .              .      .               .   .\    
   /              .                                                .                          \.  
  /      .                         .    .    .   . .                                           \  
 /                     .        .   .   .              .        ..                              \.
/       .                                                                        .     ..      . \
