\         .                   .    ..  .   .               /
|\           .     ..                                     /|
| \        .    .    .      .                            / |
| |\   .       ..     . .        .       .              /| |
| | |##################################################| | |
| | |##################################################| | |
| | |##################################################| | |
| | |##################################################| | |
| | |##################################################| |.|
| | |##################################################| | |
| | |##################################################| |.|
| | |##################################################| | |
| | |##################################################| | |
|.| |##################################################| | |
| |/                            .        .  .           \| |
| /                     .                             .  \ |
|/                .          . .  .       .               \|
/            .                                        .    \
